Iced Brain
+++++++++
+++++   +
+   +s_ +
+ M  s_ +
+   +s_ +
+++++   +
+++++++++