Iced Brain
+++++++++
+.......+
+.......+
+.M.sX..+
+.......+
+.......+
+++++++++