Blocked Paths
++++++++
++++   +
+______+
+_s+b+a+
+______+
++++ M +
++++++++